...####.....####
##.#....###...##
##...########.##
#####.........##
......##########
.###############
.....###....####
####.###.##.####
####.###.##.####
####.###.##..###
####.....###..##
#############.##
#############...